R 1080 840
NO ./texture/wall_illusion1/0.png
SO ./texture/wall_illusion2/0.png
WE ./texture/wall_illusion3/0.png
EA ./texture/wall_illusion4/0.png
F 211,134,156
C 156,178,111

    1111111111111111111111111111111111111111
    1010010010010000000000000000000000000001
    1000000000000001111111111111111111111111
    10000000100000001                       
    1111000000000000111111111111111111
       10000000000000W0000000000000001
    1111000011000000111111111111111111
    10000000110000001
    1000000000000000111111111111111
    1000000000000000000000000000001
    1111111111111111111111111111111
