R 1080 840
NO ./texture/wall_illusion1/0.png
SO ./texture/wall_illusion2/0.png
WE ./texture/wall_illusion3/0.png
EA ./texture/wall_illusion4/0.png
S 12 ./texture/sprite1/ .png 16
D ./texture/door/close.png
d ./texture/door/open.png
F 211,134,156
C 156,178,111

    1111111111111111111111111111111111111111
    1010010010010000D0000d000000D00000000001
    1000000D00000001111111111111111111111111
    10000000100000001                       
    1111002022020000111111111111111111
       1000000000000dW0000000000000001
    1111002011020000111111111111111111
    10000020110200001
    1000000000000000111111111111111
    1000002022020000000000000000001
    1111111111111111111111111111111
